-1	0	0	-1	0	0	-1	0	0	-1	0	0	-1	0	0	-1	0	0	-1	0	0	-1	0	0	-1	0	0	-1	0	0	-1	0	0	-1	0	0	-1	0	0	-1	0	0	-1	0	0	-1	0	0	-1	0	0	-1	0	0	-1	0	0	-1	0	0	-1	0	0	-1	0	0	-1	0	0	-1	0	0	-1	0	0	-1	0	0	-1	0	0	-1	0	0	-1	0	0	-1	0	0	1	3	5	-1	0	0	1	6	4	-1	0	0	-1	0	0	-1	0	0	-1	0	0	-1	0	0	-1	0	0	-1	0	0
-1	0	0	-1	0	0	-1	0	0	-2	48	9	-2	48	1	-2	48	1	-2	48	1	-2	48	1	-2	48	1	-2	48	3	-1	0	0	-1	0	0	-1	0	0	-1	0	0	-1	0	0	1	2	10	1	3	10	-1	0	0	-1	0	0	-1	0	0	-1	0	0	-1	0	0	-1	0	0	-1	0	0	-1	0	0	-1	0	0	-1	0	0	-1	0	0	-1	0	0	-1	0	0	-1	0	0	-1	0	0	1	6	5	-1	0	0	-1	0	0	-1	0	0	-1	0	0	-1	0	0	-1	0	0	-1	0	0
-1	0	0	-1	0	0	-1	0	0	-2	48	8	-2	48	0	-2	48	0	-2	48	0	-2	48	0	-2	48	0	-2	48	2	-1	0	0	-1	0	0	-1	0	0	-1	0	0	-1	0	0	1	2	11	1	3	11	-1	0	0	-1	0	0	-1	0	0	-1	0	0	-1	0	0	-1	0	0	-1	0	0	-1	0	0	-1	0	0	-1	0	0	-1	0	0	-1	0	0	-1	0	0	-1	0	0	-1	0	0	-1	0	0	1	6	5	1	7	5	1	6	5	1	7	5	-1	0	0	-1	0	0	-1	0	0
-1	0	0	-1	0	0	-1	0	0	-2	48	8	-2	48	0	-2	48	0	-2	48	0	-2	48	0	-2	48	0	-2	48	2	-1	0	0	-1	0	0	-1	0	0	-1	0	0	-1	0	0	1	2	12	1	3	12	-1	0	0	-1	0	0	-1	0	0	-1	0	0	-1	0	0	-1	0	0	-1	0	0	-1	0	0	-1	0	0	-1	0	0	-1	0	0	-2	50	9	-2	50	1	-2	50	1	-2	50	1	-2	50	3	1	3	5	-1	0	0	1	5	5	1	6	5	-1	0	0	-1	0	0	-1	0	0
-1	0	0	-1	0	0	-1	0	0	-2	48	12	-2	48	4	-2	48	4	-2	48	4	-2	48	4	-2	57	9	-2	57	3	-1	0	0	-1	0	0	-1	0	0	-1	0	0	-1	0	0	-1	0	0	-1	0	0	-1	0	0	-1	0	0	-1	0	0	-1	0	0	-1	0	0	-1	0	0	-1	0	0	-1	0	0	-1	0	0	-1	0	0	-1	0	0	-2	50	12	-2	50	4	-2	50	4	-2	50	4	-2	50	6	-1	0	0	-1	0	0	-1	0	0	1	6	4	-1	0	0	-1	0	0	-1	0	0
-1	0	0	-1	0	0	-1	0	0	-2	57	9	-2	57	1	-2	57	1	-2	57	1	-2	57	3	-2	57	8	-2	57	2	-1	0	0	-1	0	0	-1	0	0	-1	0	0	-1	0	0	-1	0	0	-1	0	0	-1	0	0	-1	0	0	-1	0	0	-1	0	0	-1	0	0	-1	0	0	-1	0	0	-1	0	0	-1	0	0	1	6	9	-1	0	0	-2	105	9	-2	105	1	-2	105	1	-2	105	1	-2	105	3	1	7	10	1	5	10	-1	0	0	1	6	5	-1	0	0	-1	0	0	-1	0	0
-1	0	0	-1	0	0	-1	0	0	-2	57	8	2	10	0	-2	57	0	-2	57	0	-2	57	2	-2	57	12	-2	57	6	-1	0	0	-1	0	0	-1	0	0	-1	0	0	-1	0	0	-1	0	0	-1	0	0	-1	0	0	-2	66	9	-2	66	1	-2	66	1	-2	66	1	-2	66	3	-1	0	0	-1	0	0	-1	0	0	1	5	4	-1	0	0	-2	105	8	-2	105	0	-2	105	0	-2	105	0	-2	105	2	1	6	10	-1	0	0	-1	0	0	-1	0	0	1	6	5	1	7	5	1	6	5
-1	0	0	-1	0	0	-1	0	0	-2	57	12	-2	57	4	-2	57	4	-2	57	4	-2	57	6	-1	0	0	-1	0	0	-1	0	0	-1	0	0	-1	0	0	-1	0	0	-1	0	0	-1	0	0	-1	0	0	-1	0	0	-2	66	12	-2	66	4	-2	66	4	-2	66	4	-2	66	6	-1	0	0	-1	0	0	-1	0	0	-1	0	0	-1	0	0	-2	105	12	-2	105	4	-2	105	4	-2	105	4	-2	105	6	-1	0	0	-1	0	0	-1	0	0	-1	0	0	1	6	8	1	7	8	-1	0	0
-1	0	0	-1	0	0	-1	0	0	-1	0	0	-1	0	0	-1	0	0	-1	0	0	-1	0	0	-1	0	0	-1	0	0	-1	0	0	-1	0	0	-1	0	0	-1	0	0	-1	0	0	-1	0	0	-1	0	0	-1	0	0	-2	76	9	-2	76	1	-2	76	1	-2	76	1	-2	76	3	-1	0	0	-1	0	0	-1	0	0	-1	0	0	-1	0	0	-1	0	0	-1	0	0	-1	0	0	-1	0	0	-1	0	0	-1	0	0	-1	0	0	-1	0	0	1	4	5	-1	0	0	1	6	4	1	7	4
-1	0	0	-1	0	0	-1	0	0	-1	0	0	-1	0	0	-1	0	0	-1	0	0	-1	0	0	-1	0	0	-1	0	0	-1	0	0	-1	0	0	-1	0	0	-1	0	0	-1	0	0	-1	0	0	-1	0	0	-1	0	0	-2	76	8	2	10	0	-2	76	0	-2	76	0	-2	76	2	-1	0	0	-1	0	0	-1	0	0	-1	0	0	-1	0	0	-1	0	0	-1	0	0	-1	0	0	-1	0	0	-1	0	0	-1	0	0	-1	0	0	-1	0	0	-1	0	0	-1	0	0	1	6	5	1	7	5
-1	0	0	-1	0	0	-1	0	0	-1	0	0	-1	0	0	-1	0	0	-1	0	0	-1	0	0	-1	0	0	-1	0	0	-1	0	0	-1	0	0	-1	0	0	-1	0	0	-1	0	0	-1	0	0	-1	0	0	-1	0	0	-2	76	12	-2	76	4	-2	76	4	-2	76	4	-2	76	6	-1	0	0	-1	0	0	-1	0	0	-1	0	0	-1	0	0	-1	0	0	-1	0	0	-1	0	0	-1	0	0	-1	0	0	-1	0	0	-1	0	0	-1	0	0	-1	0	0	-1	0	0	-1	0	0	-1	0	0
-1	0	0	-1	0	0	-2	52	9	-2	52	1	-2	52	1	-2	52	1	-2	52	1	-2	52	3	-1	0	0	-1	0	0	-1	0	0	-1	0	0	-1	0	0	-1	0	0	-1	0	0	-1	0	0	-1	0	0	-1	0	0	-1	0	0	-1	0	0	-1	0	0	-1	0	0	-1	0	0	-1	0	0	-1	0	0	-1	0	0	-1	0	0	-1	0	0	-1	0	0	-1	0	0	-1	0	0	-1	0	0	-1	0	0	-1	0	0	-1	0	0	-1	0	0	-1	0	0	-1	0	0	1	3	5	-1	0	0
-1	0	0	-1	0	0	-2	52	8	-2	52	0	-2	52	0	-2	52	0	-2	52	0	-2	52	2	-1	0	0	-1	0	0	-1	0	0	-1	0	0	-1	0	0	-1	0	0	-1	0	0	-1	0	0	-1	0	0	-1	0	0	-1	0	0	-1	0	0	-1	0	0	-1	0	0	-1	0	0	-1	0	0	-1	0	0	-1	0	0	-1	0	0	-1	0	0	-1	0	0	-1	0	0	-1	0	0	-1	0	0	-1	0	0	-1	0	0	-1	0	0	-1	0	0	-1	0	0	-1	0	0	-1	0	0	-1	0	0
-1	0	0	-1	0	0	-2	52	12	-2	52	4	-2	52	4	-2	52	4	-2	52	4	-2	52	6	-1	0	0	-1	0	0	-1	0	0	-1	0	0	-1	0	0	-1	0	0	-1	0	0	-1	0	0	-1	0	0	-1	0	0	-1	0	0	-1	0	0	-1	0	0	-1	0	0	-1	0	0	-1	0	0	-1	0	0	-1	0	0	-1	0	0	-1	0	0	-1	0	0	-1	0	0	-1	0	0	-1	0	0	1	8	7	1	9	7	1	10	7	1	11	7	1	14	0	-1	0	0	-1	0	0	-1	0	0
-1	0	0	-1	0	0	-2	56	9	-2	56	1	-2	56	1	-2	56	1	-2	56	1	-2	56	3	-1	0	0	-1	0	0	-1	0	0	-1	0	0	-1	0	0	-1	0	0	-1	0	0	-1	0	0	-1	0	0	-1	0	0	-1	0	0	-1	0	0	-1	0	0	-1	0	0	-1	0	0	-1	0	0	-1	0	0	-1	0	0	-1	0	0	-1	0	0	-1	0	0	-1	0	0	-1	0	0	1	15	3	1	8	8	1	9	8	1	10	8	1	11	8	-1	0	0	-1	0	0	1	12	0	1	13	0
-1	0	0	-1	0	0	-2	56	8	-2	56	0	-2	56	0	-2	56	0	-2	56	0	-2	56	2	-1	0	0	-1	0	0	-1	0	0	-1	0	0	-1	0	0	-1	0	0	-1	0	0	-1	0	0	-1	0	0	-1	0	0	-1	0	0	-1	0	0	-1	0	0	-1	0	0	-1	0	0	-1	0	0	-1	0	0	-1	0	0	-1	0	0	-1	0	0	-1	0	0	-1	0	0	-1	0	0	-1	0	0	1	8	9	1	9	9	1	10	9	1	11	9	-1	0	0	-1	0	0	1	12	1	1	13	1
-1	0	0	-1	0	0	-2	56	8	-2	56	0	-2	56	0	-2	56	0	-2	56	0	-2	56	2	-1	0	0	-1	0	0	-1	0	0	-1	0	0	-1	0	0	-1	0	0	-1	0	0	-1	0	0	-1	0	0	-1	0	0	-1	0	0	-1	0	0	-1	0	0	-1	0	0	-1	0	0	-1	0	0	-1	0	0	-1	0	0	-1	0	0	-1	0	0	-1	0	0	-1	0	0	-1	0	0	-1	0	0	-1	0	0	-1	0	0	-1	0	0	-1	0	0	-1	0	0	-1	0	0	-1	0	0	-1	0	0
-1	0	0	-1	0	0	-2	56	8	-2	56	0	-2	56	0	-2	56	0	-2	56	0	-2	56	2	-1	0	0	-1	0	0	-1	0	0	-1	0	0	-1	0	0	-1	0	0	-1	0	0	-1	0	0	-1	0	0	-1	0	0	-1	0	0	-1	0	0	-1	0	0	-1	0	0	-1	0	0	-1	0	0	1	14	2	1	8	4	1	9	4	1	10	4	1	11	4	-1	0	0	-1	0	0	-1	0	0	-1	0	0	-1	0	0	-1	0	0	-1	0	0	-1	0	0	-1	0	0	-1	0	0	-1	0	0
-1	0	0	-1	0	0	-2	56	8	-2	56	0	-2	56	0	-2	56	0	-2	56	0	-2	56	2	-1	0	0	-1	0	0	-1	0	0	-1	0	0	-1	0	0	-1	0	0	-1	0	0	-1	0	0	-1	0	0	-1	0	0	-1	0	0	-1	0	0	-1	0	0	-1	0	0	-1	0	0	-1	0	0	1	12	2	1	8	5	1	9	5	1	10	5	1	11	5	1	13	2	-1	0	0	-1	0	0	-1	0	0	-1	0	0	-1	0	0	-1	0	0	-1	0	0	-1	0	0	-1	0	0	-1	0	0
-1	0	0	-1	0	0	-2	56	12	-2	56	4	-2	56	4	-2	56	4	-2	56	4	-2	56	6	-1	0	0	-1	0	0	-1	0	0	-1	0	0	-1	0	0	-1	0	0	-1	0	0	-1	0	0	-1	0	0	-1	0	0	-1	0	0	-1	0	0	-1	0	0	-1	0	0	-1	0	0	-1	0	0	-1	0	0	1	8	6	1	9	6	1	10	6	1	11	6	-1	0	0	-1	0	0	-1	0	0	-1	0	0	-1	0	0	-1	0	0	-1	0	0	-1	0	0	-1	0	0	-1	0	0	-1	0	0
-1	0	0	-1	0	0	-1	0	0	-1	0	0	-1	0	0	-1	0	0	-1	0	0	-1	0	0	-1	0	0	-1	0	0	-1	0	0	-1	0	0	-1	0	0	-1	0	0	-1	0	0	-1	0	0	-1	0	0	-1	0	0	-1	0	0	-1	0	0	-1	0	0	-1	0	0	-1	0	0	-1	0	0	-1	0	0	-1	0	0	-1	0	0	-1	0	0	-1	0	0	-1	0	0	-1	0	0	-1	0	0	-1	0	0	-1	0	0	-1	0	0	-1	0	0	-1	0	0	-1	0	0	-1	0	0	-1	0	0
-1	0	0	-1	0	0	-1	0	0	-1	0	0	-1	0	0	-1	0	0	-1	0	0	-1	0	0	-1	0	0	-1	0	0	-1	0	0	-1	0	0	-1	0	0	-1	0	0	-1	0	0	-1	0	0	-1	0	0	-1	0	0	-1	0	0	-1	0	0	-1	0	0	-1	0	0	-1	0	0	-1	0	0	-1	0	0	-1	0	0	-1	0	0	-1	0	0	-1	0	0	-1	0	0	-1	0	0	-1	0	0	-1	0	0	-1	0	0	-1	0	0	-1	0	0	-1	0	0	-1	0	0	-1	0	0	-1	0	0
-1	0	0	-2	51	9	-2	51	1	-2	51	1	-2	51	1	-2	51	1	-2	51	1	-2	51	3	-1	0	0	-1	0	0	-1	0	0	-1	0	0	-1	0	0	-1	0	0	-1	0	0	-1	0	0	-1	0	0	-1	0	0	-1	0	0	-1	0	0	-1	0	0	-1	0	0	-1	0	0	-1	0	0	-1	0	0	-1	0	0	-1	0	0	-1	0	0	-1	0	0	-1	0	0	-1	0	0	-1	0	0	-1	0	0	-1	0	0	-1	0	0	-1	0	0	-1	0	0	-1	0	0	-1	0	0	-1	0	0
-1	0	0	-2	51	8	-2	51	0	-2	51	0	-2	51	0	-2	51	0	-2	51	0	-2	51	2	-1	0	0	-1	0	0	-1	0	0	-1	0	0	-1	0	0	-1	0	0	-1	0	0	-1	0	0	-1	0	0	-1	0	0	-1	0	0	-1	0	0	-1	0	0	-1	0	0	-1	0	0	-1	0	0	-1	0	0	-1	0	0	-1	0	0	-1	0	0	-1	0	0	-1	0	0	-1	0	0	-1	0	0	-1	0	0	-1	0	0	-1	0	0	-1	0	0	-1	0	0	-1	0	0	-1	0	0	-1	0	0
-1	0	0	-2	51	12	-2	51	4	-2	51	4	-2	51	4	-2	51	4	-2	51	4	-2	51	6	-1	0	0	-1	0	0	-1	0	0	-1	0	0	-1	0	0	-1	0	0	-1	0	0	-1	0	0	-1	0	0	-1	0	0	-1	0	0	-1	0	0	-1	0	0	-1	0	0	-1	0	0	-1	0	0	-1	0	0	-1	0	0	-1	0	0	-1	0	0	-1	0	0	-1	0	0	-1	0	0	-1	0	0	-1	0	0	-1	0	0	-1	0	0	-1	0	0	-1	0	0	-1	0	0	-1	0	0	-1	0	0
-1	0	0	-2	104	9	-2	104	1	-2	104	1	-2	104	1	-2	104	1	-2	104	1	-2	104	3	-1	0	0	-1	0	0	-1	0	0	-1	0	0	-1	0	0	-1	0	0	-1	0	0	-1	0	0	-1	0	0	-1	0	0	-1	0	0	-1	0	0	-1	0	0	-1	0	0	-1	0	0	-1	0	0	-1	0	0	-1	0	0	-1	0	0	-1	0	0	-1	0	0	-1	0	0	-1	0	0	-1	0	0	-1	0	0	-1	0	0	-1	0	0	-1	0	0	-1	0	0	-1	0	0	-1	0	0	-1	0	0
-1	0	0	-2	104	8	-2	104	0	-2	104	0	-2	104	0	-2	104	0	-2	104	0	-2	104	2	-1	0	0	-1	0	0	-1	0	0	-1	0	0	-1	0	0	-1	0	0	-1	0	0	-1	0	0	-1	0	0	-1	0	0	-1	0	0	-1	0	0	-1	0	0	-1	0	0	-1	0	0	-1	0	0	-1	0	0	-1	0	0	-1	0	0	-1	0	0	-1	0	0	-1	0	0	-1	0	0	-1	0	0	-1	0	0	-1	0	0	-1	0	0	-1	0	0	-1	0	0	-1	0	0	-1	0	0	-1	0	0
-1	0	0	-2	104	8	-2	104	0	-2	104	0	-2	104	0	-2	104	0	-2	104	0	-2	104	2	-1	0	0	-1	0	0	-1	0	0	-1	0	0	-1	0	0	-1	0	0	-1	0	0	-1	0	0	-1	0	0	-1	0	0	-1	0	0	-1	0	0	-1	0	0	-1	0	0	-1	0	0	-1	0	0	-1	0	0	-1	0	0	-1	0	0	-1	0	0	-1	0	0	-1	0	0	-1	0	0	-1	0	0	-1	0	0	-1	0	0	-1	0	0	-1	0	0	-1	0	0	-1	0	0	-1	0	0	-1	0	0
3	11	10	-2	104	12	-2	104	4	-2	104	4	-2	104	4	-2	104	4	-2	104	4	-2	104	6	-1	0	0	-1	0	0	-1	0	0	-1	0	0	-1	0	0	-1	0	0	-1	0	0	-1	0	0	-1	0	0	-1	0	0	-1	0	0	-1	0	0	-1	0	0	-1	0	0	-1	0	0	-1	0	0	-1	0	0	-2	17	-71	-2	17	-75	-2	17	-11	-2	17	-11	-2	17	-11	-2	17	-11	-2	17	-11	-2	17	-11	-2	17	-11	-2	17	-11	-2	17	-43	-2	17	-13	-1	0	0	-1	0	0	-1	0	0
-1	0	0	-1	0	0	-1	0	0	1	13	12	-1	0	0	-1	0	0	-1	0	0	-1	0	0	-1	0	0	-1	0	0	-1	0	0	-1	0	0	-1	0	0	-1	0	0	-1	0	0	-1	0	0	-1	0	0	-1	0	0	-1	0	0	-1	0	0	-1	0	0	-1	0	0	-2	17	-7	-2	17	-75	-2	17	-27	-2	17	-26	1	11	11	1	12	11	-1	0	0	-1	0	0	-1	0	0	-1	0	0	-1	0	0	-1	0	0	-1	0	0	1	13	12	-2	17	122	-1	0	0	-1	0	0	-1	0	0
-1	0	0	-1	0	0	-1	0	0	-1	0	0	-1	0	0	-1	0	0	-1	0	0	-1	0	0	-1	0	0	-1	0	0	-1	0	0	-1	0	0	-1	0	0	-1	0	0	-1	0	0	-1	0	0	-1	0	0	-1	0	0	-1	0	0	-1	0	0	-1	0	0	-1	0	0	-2	17	-22	-1	0	0	-1	0	0	-1	0	0	1	11	12	1	12	12	-1	0	0	-1	0	0	-1	0	0	-1	0	0	-1	0	0	-1	0	0	-1	0	0	-1	0	0	-2	17	-38	-1	0	0	-1	0	0	-1	0	0
-1	0	0	-1	0	0	-1	0	0	-1	0	0	-1	0	0	-1	0	0	-1	0	0	-1	0	0	-1	0	0	-1	0	0	-1	0	0	-1	0	0	-1	0	0	-1	0	0	-1	0	0	-1	0	0	-1	0	0	-1	0	0	-1	0	0	-1	0	0	-1	0	0	-1	0	0	-2	17	-6	-1	0	0	-1	0	0	-1	0	0	-1	0	0	-1	0	0	-1	0	0	-1	0	0	-1	0	0	-1	0	0	-1	0	0	-1	0	0	-1	0	0	-1	0	0	-2	17	-36	-2	17	115	-1	0	0	-1	0	0
-1	0	0	-1	0	0	-1	0	0	-1	0	0	-1	0	0	-1	0	0	-1	0	0	-1	0	0	-1	0	0	-1	0	0	-1	0	0	-1	0	0	-1	0	0	-1	0	0	-1	0	0	-1	0	0	-1	0	0	-1	0	0	-1	0	0	-1	0	0	-1	0	0	-1	0	0	-2	17	-38	-1	0	0	-1	0	0	-1	0	0	-1	0	0	-1	0	0	-1	0	0	-1	0	0	-1	0	0	-1	0	0	-1	0	0	-1	0	0	-1	0	0	-1	0	0	-1	0	0	-2	17	122	-1	0	0	-1	0	0
4	4	2	-1	0	0	-1	0	0	-1	0	0	-1	0	0	-1	0	0	-1	0	0	-1	0	0	-1	0	0	-1	0	0	-1	0	0	-1	0	0	-1	0	0	-1	0	0	-1	0	0	-1	0	0	-1	0	0	-1	0	0	-1	0	0	-1	0	0	-1	0	0	-1	0	0	-2	17	-4	-2	17	117	-2	17	-43	-2	17	-45	-1	0	0	-1	0	0	-1	0	0	-1	0	0	-1	0	0	-1	0	0	-1	0	0	-1	0	0	1	11	11	1	12	11	-1	0	0	-2	17	-70	-1	0	0	-1	0	0
1	6	4	1	7	4	-1	0	0	-2	68	9	-2	68	1	-2	68	1	-2	68	1	-2	68	3	-1	0	0	-1	0	0	-1	0	0	-1	0	0	-1	0	0	-1	0	0	-1	0	0	-1	0	0	-1	0	0	-1	0	0	-1	0	0	-1	0	0	-1	0	0	-1	0	0	-1	0	0	-1	0	0	-1	0	0	-2	17	124	-2	17	117	-2	17	-11	-2	17	-11	-2	17	-43	-2	17	-45	-1	0	0	-1	0	0	-1	0	0	1	11	12	1	12	12	-2	17	-87	-2	17	-74	-1	0	0	-1	0	0
1	6	5	1	7	5	-1	0	0	-2	68	12	-2	68	4	-2	68	4	-2	68	4	-2	68	6	-1	0	0	-1	0	0	-1	0	0	-1	0	0	-1	0	0	-1	0	0	-1	0	0	-1	0	0	-1	0	0	-1	0	0	-1	0	0	-1	0	0	-1	0	0	-1	0	0	-1	0	0	-1	0	0	1	10	11	1	12	11	1	12	10	-1	0	0	-1	0	0	-1	0	0	-2	17	124	-2	17	117	-2	17	-11	-2	17	-11	-2	17	-11	-2	17	-27	-2	17	-26	-1	0	0	-1	0	0	-1	0	0
-1	0	0	-1	0	0	-1	0	0	-2	57	9	-2	57	1	-2	57	1	-2	57	1	-2	57	3	-1	0	0	-1	0	0	-1	0	0	-1	0	0	-1	0	0	-1	0	0	-1	0	0	-1	0	0	-1	0	0	-1	0	0	-1	0	0	-1	0	0	-1	0	0	-1	0	0	-1	0	0	-1	0	0	1	11	12	1	12	12	-1	0	0	-1	0	0	-1	0	0	-1	0	0	-1	0	0	-1	0	0	-1	0	0	-1	0	0	-1	0	0	-1	0	0	-1	0	0	-1	0	0	-1	0	0	-1	0	0
4	6	15	4	7	15	-1	0	0	-2	57	8	-2	57	0	-2	57	0	-2	57	0	-2	57	2	-1	0	0	-1	0	0	-1	0	0	-1	0	0	-1	0	0	-1	0	0	-1	0	0	-1	0	0	-1	0	0	-1	0	0	-1	0	0	-1	0	0	-1	0	0	-1	0	0	-1	0	0	-1	0	0	-1	0	0	-1	0	0	-1	0	0	-1	0	0	1	6	14	1	6	14	1	6	14	1	6	14	1	6	14	1	7	14	1	6	14	1	7	14	1	7	14	-1	0	0	-1	0	0	-1	0	0
4	5	2	-1	0	0	-1	0	0	-2	57	12	-2	57	4	-2	57	4	-2	57	4	-2	57	6	-1	0	0	-1	0	0	-1	0	0	-1	0	0	-1	0	0	-1	0	0	-1	0	0	-1	0	0	-1	0	0	-1	0	0	-1	0	0	-1	0	0	-1	0	0	-1	0	0	-1	0	0	-1	0	0	-1	0	0	-1	0	0	-1	0	0	-1	0	0	1	6	14	1	6	14	-1	0	0	1	6	14	1	7	14	1	7	14	-1	0	0	1	6	14	1	7	14	-1	0	0	-1	0	0	-1	0	0
4	5	3	1	7	4	-1	0	0	-1	0	0	-1	0	0	-1	0	0	-1	0	0	-1	0	0	-1	0	0	-1	0	0	-1	0	0	-1	0	0	-1	0	0	-1	0	0	-1	0	0	-1	0	0	-1	0	0	-1	0	0	-1	0	0	-1	0	0	-1	0	0	-1	0	0	-1	0	0	-1	0	0	-1	0	0	-1	0	0	-1	0	0	-1	0	0	-1	0	0	1	7	14	1	7	14	1	7	14	1	7	14	1	7	14	1	7	14	1	7	14	1	6	14	-1	0	0	-1	0	0	-1	0	0
-1	0	0	1	7	5	-1	0	0	-1	0	0	-1	0	0	-1	0	0	-1	0	0	-1	0	0	-1	0	0	-1	0	0	-1	0	0	-1	0	0	-1	0	0	-1	0	0	-1	0	0	-1	0	0	-1	0	0	-1	0	0	-1	0	0	-1	0	0	-1	0	0	-1	0	0	-1	0	0	-1	0	0	-1	0	0	-1	0	0	1	1	5	-1	0	0	1	7	15	-1	0	0	1	7	15	1	7	15	-1	0	0	1	7	14	1	7	14	1	6	15	1	6	15	-1	0	0	1	6	4	1	7	4
-1	0	0	1	7	4	-1	0	0	1	6	4	1	7	4	-1	0	0	-1	0	0	-1	0	0	-1	0	0	-1	0	0	-1	0	0	-1	0	0	-1	0	0	-1	0	0	-1	0	0	-1	0	0	-1	0	0	-1	0	0	-1	0	0	-1	0	0	-1	0	0	-1	0	0	-1	0	0	-1	0	0	-1	0	0	-1	0	0	-1	0	0	-1	0	0	1	7	15	1	7	15	1	7	15	1	7	15	1	7	15	1	7	15	1	6	15	1	6	15	1	6	15	-1	0	0	1	6	5	1	7	5
-1	0	0	1	7	5	-1	0	0	1	6	5	1	7	5	-1	0	0	-1	0	0	-1	0	0	-1	0	0	-1	0	0	-1	0	0	-1	0	0	-1	0	0	-1	0	0	-1	0	0	-1	0	0	-1	0	0	-1	0	0	-1	0	0	-1	0	0	-1	0	0	-1	0	0	-1	0	0	-1	0	0	-1	0	0	-1	0	0	-1	0	0	-1	0	0	1	6	15	1	6	15	1	6	14	-1	0	0	1	6	15	1	6	15	1	6	15	1	6	14	1	6	14	-1	0	0	-1	0	0	-1	0	0
-1	0	0	1	7	4	-1	0	0	-1	0	0	-1	0	0	-1	0	0	-1	0	0	-1	0	0	-1	0	0	-1	0	0	-1	0	0	-1	0	0	-1	0	0	-1	0	0	-1	0	0	-1	0	0	-1	0	0	-1	0	0	-1	0	0	-1	0	0	-1	0	0	-1	0	0	-1	0	0	-1	0	0	-1	0	0	-1	0	0	-1	0	0	-1	0	0	1	6	14	1	6	14	1	6	15	1	6	15	1	6	15	1	6	14	1	6	14	-1	0	0	-1	0	0	-1	0	0	-1	0	0	-1	0	0
-1	0	0	1	7	5	-1	0	0	-1	0	0	-1	0	0	-1	0	0	-1	0	0	-1	0	0	-1	0	0	-1	0	0	-1	0	0	-1	0	0	-1	0	0	-1	0	0	-1	0	0	-1	0	0	-1	0	0	-1	0	0	-1	0	0	-1	0	0	-1	0	0	-1	0	0	-1	0	0	-1	0	0	-2	66	9	-2	66	1	-2	66	1	-2	66	1	-2	66	3	-1	0	0	-1	0	0	-1	0	0	-1	0	0	-1	0	0	-1	0	0	-1	0	0	-1	0	0	-1	0	0	-1	0	0	-1	0	0
-1	0	0	1	7	4	1	6	4	1	7	4	-1	0	0	-1	0	0	-1	0	0	-1	0	0	-1	0	0	-1	0	0	-1	0	0	-1	0	0	-1	0	0	-1	0	0	-1	0	0	-1	0	0	-1	0	0	-1	0	0	-1	0	0	-1	0	0	-1	0	0	-1	0	0	-1	0	0	-1	0	0	-2	66	12	-2	66	4	-2	66	4	-2	66	4	-2	66	6	-1	0	0	-1	0	0	-1	0	0	-1	0	0	-1	0	0	-1	0	0	-1	0	0	-1	0	0	-1	0	0	-1	0	0	1	6	4
-1	0	0	-1	0	0	-1	0	0	1	7	5	-1	0	0	-1	0	0	-1	0	0	-1	0	0	-1	0	0	-1	0	0	-1	0	0	-1	0	0	-1	0	0	-1	0	0	-1	0	0	-1	0	0	-1	0	0	-1	0	0	-1	0	0	-1	0	0	-1	0	0	-1	0	0	-1	0	0	-1	0	0	-2	56	9	-2	56	1	-2	56	1	-2	56	1	-2	56	3	-1	0	0	-1	0	0	-1	0	0	-1	0	0	-1	0	0	-1	0	0	-1	0	0	-1	0	0	-1	0	0	1	6	4	-1	0	0
-1	0	0	-1	0	0	-1	0	0	1	7	4	-1	0	0	-1	0	0	-1	0	0	-1	0	0	-1	0	0	-1	0	0	-1	0	0	-1	0	0	-1	0	0	-1	0	0	-1	0	0	-1	0	0	-1	0	0	-1	0	0	-1	0	0	-1	0	0	-1	0	0	-1	0	0	-1	0	0	-1	0	0	-2	56	8	-2	56	0	-2	56	0	-2	56	0	-2	56	2	-1	0	0	-1	0	0	-1	0	0	-1	0	0	-1	0	0	-1	0	0	-1	0	0	-1	0	0	1	6	4	-1	0	0	-1	0	0
-1	0	0	-1	0	0	-1	0	0	1	7	5	1	7	4	-1	0	0	1	6	4	1	7	4	-1	0	0	-1	0	0	-1	0	0	-1	0	0	-1	0	0	-1	0	0	-1	0	0	-1	0	0	-1	0	0	-1	0	0	-1	0	0	-1	0	0	-1	0	0	-1	0	0	-1	0	0	-1	0	0	-2	56	12	-2	56	4	-2	56	4	-2	56	4	-2	56	6	-1	0	0	-1	0	0	-1	0	0	-1	0	0	-1	0	0	-1	0	0	-1	0	0	1	6	4	1	6	5	-1	0	0	-1	0	0
-1	0	0	-1	0	0	-1	0	0	-1	0	0	1	7	5	-1	0	0	1	6	5	1	7	5	-1	0	0	-1	0	0	-1	0	0	-1	0	0	-1	0	0	-1	0	0	-1	0	0	-1	0	0	-1	0	0	-1	0	0	-1	0	0	-1	0	0	-1	0	0	-1	0	0	-1	0	0	-1	0	0	-1	0	0	-1	0	0	-1	0	0	-1	0	0	-1	0	0	-1	0	0	-1	0	0	-1	0	0	-1	0	0	-1	0	0	-1	0	0	1	6	4	1	6	5	-1	0	0	-1	0	0	-1	0	0
-1	0	0	-1	0	0	-1	0	0	1	6	4	1	7	4	-1	0	0	-1	0	0	-1	0	0	-1	0	0	-1	0	0	-1	0	0	-1	0	0	-1	0	0	-1	0	0	-1	0	0	-1	0	0	-1	0	0	-1	0	0	-1	0	0	-1	0	0	-1	0	0	-1	0	0	-1	0	0	-1	0	0	-1	0	0	-1	0	0	-1	0	0	-1	0	0	-1	0	0	-1	0	0	1	6	4	1	7	4	-1	0	0	-1	0	0	1	6	4	-1	0	0	-1	0	0	-1	0	0	-1	0	0	-1	0	0
-1	0	0	-1	0	0	-1	0	0	-1	0	0	1	7	5	1	7	4	-1	0	0	-1	0	0	-1	0	0	-1	0	0	-1	0	0	-1	0	0	-1	0	0	-1	0	0	-1	0	0	-1	0	0	-1	0	0	-1	0	0	-1	0	0	-1	0	0	-1	0	0	-1	0	0	-1	0	0	-1	0	0	-1	0	0	-1	0	0	-1	0	0	-1	0	0	-1	0	0	-1	0	0	1	6	5	1	7	5	-1	0	0	-1	0	0	1	6	5	-1	0	0	-1	0	0	-1	0	0	-1	0	0	-1	0	0
-1	0	0	-1	0	0	-1	0	0	-1	0	0	-1	0	0	1	7	5	-1	0	0	-1	0	0	-1	0	0	-1	0	0	-1	0	0	-1	0	0	-1	0	0	-1	0	0	-1	0	0	-1	0	0	-1	0	0	-1	0	0	-1	0	0	-1	0	0	-1	0	0	-1	0	0	-1	0	0	-1	0	0	-1	0	0	-1	0	0	-1	0	0	-1	0	0	-1	0	0	-1	0	0	-1	0	0	-1	0	0	1	6	4	1	7	4	1	6	4	-1	0	0	-1	0	0	-1	0	0	-1	0	0	-1	0	0
-1	0	0	-1	0	0	-1	0	0	-1	0	0	-1	0	0	1	7	4	1	6	4	1	7	4	-1	0	0	-1	0	0	-1	0	0	-1	0	0	-1	0	0	-1	0	0	-1	0	0	-1	0	0	-1	0	0	-1	0	0	-1	0	0	-1	0	0	-1	0	0	-1	0	0	-1	0	0	-1	0	0	-1	0	0	-1	0	0	-1	0	0	-1	0	0	-1	0	0	-1	0	0	-1	0	0	-1	0	0	1	6	5	-1	0	0	-1	0	0	-1	0	0	-1	0	0	-1	0	0	-1	0	0	-1	0	0
-1	0	0	-1	0	0	-1	0	0	-1	0	0	-1	0	0	-1	0	0	-1	0	0	1	7	5	1	7	4	-1	0	0	1	6	4	1	7	4	-1	0	0	-1	0	0	-1	0	0	-1	0	0	-1	0	0	-1	0	0	-1	0	0	-1	0	0	-1	0	0	-1	0	0	-1	0	0	-1	0	0	-1	0	0	-1	0	0	-1	0	0	-1	0	0	-1	0	0	-1	0	0	-1	0	0	-1	0	0	-1	0	0	-1	0	0	-1	0	0	-1	0	0	-1	0	0	-1	0	0	-1	0	0	-1	0	0
-1	0	0	-1	0	0	-1	0	0	-1	0	0	-1	0	0	-1	0	0	-1	0	0	-1	0	0	1	7	5	1	7	4	1	6	5	1	7	5	-1	0	0	-1	0	0	-1	0	0	-1	0	0	-1	0	0	-1	0	0	-1	0	0	-1	0	0	-1	0	0	-1	0	0	-1	0	0	-1	0	0	-1	0	0	-1	0	0	-1	0	0	-1	0	0	1	6	4	1	7	4	-1	0	0	1	6	4	-1	0	0	-1	0	0	-1	0	0	-1	0	0	-1	0	0	-1	0	0	-1	0	0	-1	0	0
-1	0	0	-1	0	0	-1	0	0	-1	0	0	-1	0	0	-1	0	0	-1	0	0	-1	0	0	-1	0	0	1	7	5	-1	0	0	-1	0	0	-1	0	0	-1	0	0	-1	0	0	-1	0	0	-1	0	0	-1	0	0	-1	0	0	-1	0	0	-1	0	0	-1	0	0	-1	0	0	-1	0	0	-1	0	0	-1	0	0	-1	0	0	-1	0	0	1	6	5	1	7	5	1	6	4	-1	0	0	-1	0	0	-1	0	0	-1	0	0	-1	0	0	-1	0	0	-1	0	0	-1	0	0	-1	0	0
-1	0	0	-1	0	0	-1	0	0	-1	0	0	-1	0	0	-1	0	0	-1	0	0	-1	0	0	-1	0	0	1	7	4	1	6	4	1	7	4	-1	0	0	-1	0	0	-1	0	0	-1	0	0	-1	0	0	-1	0	0	-1	0	0	-1	0	0	-1	0	0	-1	0	0	-1	0	0	-1	0	0	-1	0	0	-1	0	0	-1	0	0	-1	0	0	-1	0	0	1	6	4	-1	0	0	-1	0	0	-1	0	0	-1	0	0	-1	0	0	-1	0	0	-1	0	0	-1	0	0	-1	0	0	-1	0	0
-1	0	0	-1	0	0	-1	0	0	-1	0	0	-1	0	0	-1	0	0	-1	0	0	-1	0	0	-1	0	0	-1	0	0	-1	0	0	1	7	5	-1	0	0	-1	0	0	-1	0	0	-1	0	0	-1	0	0	-1	0	0	-1	0	0	-1	0	0	-1	0	0	-1	0	0	-1	0	0	-1	0	0	-1	0	0	-1	0	0	-1	0	0	-1	0	0	1	6	4	-1	0	0	-1	0	0	-1	0	0	-1	0	0	-1	0	0	-1	0	0	-1	0	0	-1	0	0	-1	0	0	-1	0	0	-1	0	0
-1	0	0	-1	0	0	-1	0	0	-1	0	0	-1	0	0	-1	0	0	-1	0	0	-1	0	0	-1	0	0	-1	0	0	-1	0	0	1	7	4	-1	0	0	-1	0	0	-1	0	0	-1	0	0	-1	0	0	-1	0	0	-1	0	0	-1	0	0	-1	0	0	-1	0	0	-1	0	0	-1	0	0	-1	0	0	-1	0	0	-1	0	0	-1	0	0	1	6	5	-1	0	0	-1	0	0	-1	0	0	-1	0	0	-1	0	0	-1	0	0	-1	0	0	-1	0	0	-1	0	0	-1	0	0	-1	0	0
